              FOG LIBRARY DISK

Copyright (1986) by First Osborne Group (FOG) to the 
extent not copyrighted by the original author for 
the exclusive use and enjoyment of its members.  Any 
reproduction or distribution for profit or personal 
gain is strictly forbidden.  For information, 
contact FOG, P. O. Box 3474, Daly City, CA. 94015-0474.

   Filename      CRC         Description
-FOG/CPM.041:		Osborne 1 graphics programs
//CPM041.DOC:	
/APR/86 .   :	
AL-LOGO .ASM:	26 D7	Assembly language graphics routine
AL-LOGO .COM:	07 9B	Prints logo on screen
ALGRAPHS.ASM:	05 DC	Assembler source for ALGRAPHS
ALGRAPHS.COM:	29 F3	Displays O1 graphics set on screen
AUTOCHG .SUB:	BB DF	Replace AUTOST graphics with GFX memory
AUTOREP .BAS:	D2 56	Memory load for AUTOST gfx
AUTOST  .COM:	E1 1A	Used with GFX program
BATS    .GFX:	D9 E6	
GFX     .BAS:	E2 B5	GFX - a total graphics editor for screen/printer
GFX     .COM:	F9 ED	Compiled GFX.BAS
GFX     .DOC:	FD D3	Help and instructions
GFX1    .GFX:	6D DB	- With this program you can create pictures on your
GFX2    .GFX:	BF A3	  screen, save them to disk, print them, and make
GFX3    .GFX:	7E 39	  your own 'slide shows'
GFXDATA .CEC:	73 4D	GFX main data file
GFXTITLE.CEC:	D5 55	GFX big letter data file
OLD/NEW .BAS:	57 E1	Converts GFX files to Mbasic format 
RIENDEER.GFX:	38 3D
SANTA   .GFX:	D7 0B
SHIP    .GFX:	D8 EB
SLIEGH  .GFX:	6A 81
SUPER   .GFX:	9F D9
TRAIN   .GFX:	18 56	All .GFX files are saved graphic demo pictures
TURKEY  .GFX:	F3 E6
WELCOME .GFX:	27 1C
WITCH   .GFX:	33 1F
